    1 Мая площадь Киевский район
    1 Мая улица	Основянский район
    1-й Аравійський в’їзд 	Основянский район
    1-й Верхний проезд	Новобаварский район
    1-й Золочевский переулок	Холодногорский район
    1-й Истоминский переулок	Московский район
    1-й Кільцевий переулок	Киевский район
    1-й Лесопарковский переулок	Киевский район
    1-й Механизаторский переулок	Московский район
    1-й Орский переулок	Шевченковский район
    1-й Плодородный переулок	Немышлянский район
    1-й Тракторный переулок	Немышлянский район
    1-я Поперечная улица	Московский район
    12 Апреля улица	Индустриальный район
    2-й Игоря Муратова переулок (бывш. 2-й Тиняковский переулок)	Холодногорский район
    2-й Бассейный переулок	Киевский район
    2-й Вологодский въезд	Киевский район
    2-й Вологодський в’їзд 	Киевский район
    2-й Георгиевский переулок (бывш. 2-й Советский переулок)	Киевский район
    2-й Даниловский проезд	Киевский район
    2-й Дорошенковский въезд улица	Шевченковский район
    2-й Дорошенковский переулок	Шевченковский район
    2-й Истоминский переулок	Московский район
    2-й Лесопарковский переулок	Киевский район
    2-й Неманский проезд	Индустриальный район
    2-й Неманський проезд	Индустриальный район
    2-й Орловский проезд	Слободской район
    2-й Сокільницький в’їзд 	Шевченковский район
    2-й Старокрымский переулок	Холодногорский район
    2-й Таганский переулок	Холодногорский район
    23 Августа переулок	Шевченковский район
    23 Августа улица	Шевченковский район
    3-й Георгіївський в’їзд 	Основянский район
    3-й Зерновой проезд	Слободской район
    3-й Луговой проезд	Немышлянский район
    3-й Макіївський в’їзд 	Основянский район
    3-й Станковый въезд	Индустриальный район
    3-й Таганский переулок	Холодногорский район
    5-й Зеленодольский проезд	Индустриальный район
    50-летия СССР улица	Московский район
    50-річчя ВЛКСМ проспект	Московский район
    50-річчя СРСР проспект	Слободской район
    7-й Гвардейской Армии улица	Немышлянский район
    8 Марта улица	Холодногорский район
    Ivana Karkacha blvd 	Индустриальный район
    Абрамівська улица	Новобаварский район
    Авиахимическая улица	Шевченковский район
    Авиационная улица	Шевченковский район
    Аврамовская улица	Новобаварский район
    авто Київ-Харків-Довжанський, 517км+320м дорога	Индустриальный район
    Автогенная улица	Немышлянский район
    Автострадна набережная	Московский район
    Автострадная набережная	Московский район
    Автострадный переулок	Московский район
    Автотракторная улица	Московский район
    Аграрная улица	Шевченковский район
    Агрономическая улица	Основянский район
    Адыгейская улица	Московский район
    Адыгейский переулок	Московский район
    Азербайджанская улица	Основянский район
    Азербайджанский проезд	Основянский район
    Азовстальская улица	Новобаварский район
    Айвазовского улица	Немышлянский район
    Академика Богомольца улица	Новобаварский район
    Академика Вальтера улица	Киевский район
    Академика Волкова улица	Киевский район
    Академика Курчатова проспект	Киевский район
    Академика Подгорного переулок	Немышлянский район
    Академика Подгорного улица	Немышлянский район
    Академика Проскуры улица	Киевский район
    Академика Синельникова улица	Киевский район
    Академика Филиппова улица	Немышлянский район
    Академика Юрьева бульвар	Немышлянский район
    Академическая улица	Киевский район
    Академіка Барабашова улица	Киевский район
    Академіка Вєркіна улица	Шевченковский район
    Академіка Ляпунова улица	Шевченковский район
    Академіка Сергєєва улица	Киевский район
    Академіка Синельникова улица	Киевский район
    Актюбинская улица	Слободской район
    Александра Матросова улица	Слободской район
    Александра Матросова улица	Слободской район
    Александра Невского улица	Основянский район
    Александровский переулок	Киевский район
    Александровский проспект	Индустриальный район
    Алексеевская линия метро	Шевченковский район
    Алексеевская улица	Шевченковский район
    Алмазная улица	Холодногорский район
    Алупкинская улица	Шевченковский район
    Алуштинская улица	Холодногорский район
    Алчевских улица	Киевский район
    Алчевских улица (бывш. улица Артёма)	Киевский район
    Альпійська улица	Киевский район
    Алябьева переулок	Холодногорский район
    Амосова улица (бывш. улица Корчагинцев)	Немышлянский район
    Амурская улица	Киевский район
    Амурский переулок	Киевский район
    Анадирський переулок	Слободской район
    Ангарская улица	Московский район
    Андреевская улица	Холодногорский район
    Андрея Ощепкова улица	Немышлянский район
    Антона Чехова переулок	Киевский район
    Антонина Сохора улица	Основянский район
    Аптекарский переулок	Основянский район
    Аптекарский переулок	Основянский район
    Аравийская улица	Основянский район
    Аравійська улица	Основянский район
    Арктическая улица	Киевский район
    Арктична улица	Киевский район
    Арматурная улица	Основянский район
    Армейская улица	Шевченковский район
    Армянский переулок	Основянский район
    Арсенальная улица	Новобаварский район
    Артиллерийская улица	Шевченковский район
    Артюховский переулок	Основянский район
    Артюхівська улица	Основянский район
    Артёма Веделя улица	Московский район
    Архитектора Альошина проспект	Индустриальный район
    Архитектора Алёшина проспект	Индустриальный район
    Архитекторов улица	Шевченковский район
    Аскольдовская улица	Слободской район
    Аскольдівська улица	Слободской район
    Астраханская улица	Киевский район
    Астрономическая улица	Киевский район
    Афанасьевская улица	Холодногорский район
    Афанасівський переулок	Холодногорский район
    Афган сектор 	Киевский район
    Ахсарова улица	Шевченковский район
    Ахієзерів улица	Московский район
    Ашхабадская улица	Холодногорский район
    Ашхабадский переулок	Холодногорский район
    Аэрофлотская улица	Слободской район
    Бабаевская улица	Новобаварский район
    Баварская улица	Новобаварский район
    Багалея улица (бывш. улица Фрунзе)	Киевский район
    Багратиона улица	Немышлянский район
    Байкальский переулок	Московский район
    Бакинская улица	Новобаварский район
    Бакулина улица	Шевченковский район
    Бакулина улица	Шевченковский район
    Бакуліна улица	Шевченковский район
    Бакунина переулок	Новобаварский район
    Бакунина улица	Новобаварский район
    Балавенского переулок	Киевский район
    Балакирева переулок	Шевченковский район
    Балакирева улица	Шевченковский район
    Балакірєва в’їзд 	Шевченковский район
    Балакірєва улица	Шевченковский район
    Балашовская улица	Слободской район
    Балашовский переулок	Слободской район
    Балашовский проезд	Слободской район
    Балашовський проезд	Слободской район
    Балканская улица	Немышлянский район
    Банный переулок	Основянский район
    Баркалова улица (бывш. улица Тельмана)	Новобаварский район
    Барнаульская улица	Киевский район
    Баррикадная улица	Холодногорский район
    Бархатный переулок	Московский район
    Батайская улица	Основянский район
    Батумская улица	Шевченковский район
    Батуринская улица	Основянский район
    Башкирская улица	Холодногорский район
    Башкирский переулок	Холодногорский район
    Безлюдовская улица	Основянский район
    Бекетова улица	Индустриальный район
    Белгородский спуск	Киевский район
    Белгородское шоссе	Шевченковский район
    Белинского улица	Новобаварский район
    Белобровский переулок	Шевченковский район
    Белогорская улица	Шевченковский район
    Белой Акации улица	Шевченковский район
    Белорусская улица	Холодногорский район
    Белостокский переулок	Московский район
    Береговая улица	Шевченковский район
    Беркоса улица (бывш. Довгалевская улица)	Холодногорский район
    Бескрайняя улица	Киевский район
    Бессарабская улица	Холодногорский район
    Бестужева улица	Московский район
    Библика улица (бывш. улица 2-й Пятилетки)	Индустриальный район
    Биологическая улица	Основянский район
    Благовещенская площадь	Холодногорский район
    Благовещенская площадь (бывш. площадь Карла Маркса)	Холодногорский район
    Благовещенская улица (бывш. улица Карла Маркса)	Холодногорский район
    Благодатная улица	Немышлянский район
    Близнюківська улица	Шевченковский район
    Бобруйская улица	Московский район
    Богдана Хмельницкого бульвар	Немышлянский район
    Богдана Хмельницкого улица	Основянский район
    Бойова улица	Шевченковский район
    Болгарский переулок	Новобаварский район
    Болонская улица	Немышлянский район
    Большая Гончаровская улица	Новобаварский район
    Большая Даниловская улица	Киевский район
    Большая Жихорская улица	Основянский район
    Большая Кольцевая улица	Индустриальный район
    Большая Панасовская улица (бывш. улица Котлова)	Холодногорский район
    Большой Даниловский переулок	Киевский район
    Борзенко улица	Холодногорский район
    Борзенко улица	Холодногорский район
    Борзый переулок	Холодногорский район
    Бориса Ромашова улица	Киевский район
    Бориса Чичибабина улица	Шевченковский район
    Бориса Чичибабина улица	Шевченковский район
    Бориса Шрамко улица	Холодногорский район
    Бориса Шрамко улица (бывш. улица Дацько)	Холодногорский район
    Борисовская улица	Киевский район
    Борисоглебская улица	Основянский район
    Боровая улица	Новобаварский район
    Бородина улица	Шевченковский район
    Борьбы улица	Немышлянский район
    Ботанический переулок	Шевченковский район
    Братская улица	Немышлянский район
    Бригадная улица	Основянский район
    Броненосца Потёмкин улица	Московский район
    Броненосця "Потьомкін" улица	Слободской район
    Брянский переулок	Слободской район
    Брянський переулок	Слободской район
    Бугрименка улица	Новобаварский район
    Бугримовой площадь	Основянский район
    Буковая улица	Шевченковский район
    Буковинская улица	Немышлянский район
    Буковый переулок	Шевченковский район
    Бурсацкий спуск	Шевченковский район
    Бучмы улица (бывш. улица Командарма Уборевича)	Московский район
    Вавилова улица	Шевченковский район
    Вагнера улица	Московский район
    Вагонная улица	Новобаварский район
    Валдайская улица	Основянский район
    Валентиновская улица (бывш. улица Блюхера)	Московский район
    Валерьяновская улица	Основянский район
    Валерія Петросова улица	Новобаварский район
    Варламівський переулок	Слободской район
    Василия Клочкова улица	Индустриальный район
    Василия Мельникова улица (бывш. улица Межлаука)	Немышлянский район
    Василия Стуса улица	Московский район
    Ватутина улица	Немышлянский район
    Ващенковский переулок	Основянский район
    Ващенківський в’їзд 	Основянский район
    Велозаводская улица	Немышлянский район
    Вербная улица	Холодногорский район
    Вербовая улица	Слободской район
    Верещагина переулок	Московский район
    Верещаковский проезд (бывш. улица Красного Милиционера)	Основянский район
    Веринская улица	Киевский район
    Вернадского улица (бывш. улица Академика Вернадского)	Основянский район
    Верстатобудивна 	Индустриальный район
    Верхнегиевская улица	Холодногорский район
    Верхняя Гиевская улица	Холодногорский район
    Верховский переулок	Холодногорский район
    Веснина улица	Киевский район
    Весняный переулок	Московский район
    Весёлая улица	Шевченковский район
    Винниченко улица	Киевский район
    Виноградная улица	Холодногорский район
    Витебская улица	Холодногорский район
    Вишнёвая улица	Слободской район
    Владимира Сосюры улица	Основянский район
    Владимира Усенко переулок (бывш. Социалистический переулок)	Холодногорский район
    Владимирская улица	Новобаварский район
    Владимирская улица	Новобаварский район
    Владислава Зубенко улица (бывш. улица Тимуровцев)	Московский район
    Власенко улица	Новобаварский район
    Военная улица	Основянский район
    Возрождения переулок	Немышлянский район
    Возрождения улица	Немышлянский район
    Вокзальная улица	Основянский район
    Вологодская улица	Киевский район
    Вологодський в’їзд 	Киевский район
    Воложановская улица	Новобаварский район
    Волонтерська улица	Холодногорский район
    Волонтёрская улица (бывш. Социалистическая улица)	Холодногорский район
    Волосная улица	Новобаварский район
    Волховская улица	Московский район
    Волынская улица	Основянский район
    Воробьёва переулок	Киевский район
    Воробьёва улица	Киевский район
    Воскобойницкая улица	Немышлянский район
    Воскресенская улица (бывш. улица Урицкого)	Основянский район
    Восстания площадь	Основянский район
    Восьмого Березня улица	Холодногорский район
    Врубеля улица	Новобаварский район
    въезд на парковку 	Индустриальный район
    Выробнича улица	Немышлянский район
    Высокогорная улица	Немышлянский район
    Высокогорный проезд	Немышлянский район
    Вятская улица	Киевский район
    Вячеслава Черновола улица	Шевченковский район
    Гагарина переулок	Московский район
    Гагарина улица	Слободской район
    Галини Нікітіної улица	Киевский район
    Галинская улица	Киевский район
    Галины Никитиной улица	Киевский район
    Галушкинская улица	Основянский район
    Гарибальди улица	Московский район
    Гаркуши улица	Киевский район
    Гаршина улица	Киевский район
    Гастелло улица	Киевский район
    Гацева улица	Киевский район
    Гвардейцев-Железнодорожников улица	Новобаварский район
    Гвардейцев-Широнинцев улица	Московский район
    Гвардійців-Широнинців улица	Московский район
    Генерала Момота улица (бывш. улица 3-го Интернационала)	Индустриальный район
    Генерала Удовиченко улица	Киевский район
    Георгиевская улица	Основянский район
    Герасимовская улица	Киевский район
    Героев Небесной Сотни площадь	Основянский район
    Героев Сталинграда проспект	Слободской район
    Героев Сталинграда проспект	Слободской район
    Героев Труда улица	Московский район
    Героїв Небесної Сотні майдан 	Основянский район
    Герцена переулок	Новобаварский район
    Герцена улица	Новобаварский район
    Гетманская улица	Основянский район
    Гидропарковая улица (бывш. улица Милиционера)	Киевский район
    Гимназическая набережная (бывш. Красношкольная набережная)	Основянский район
    Гиршмана улица	Киевский район
    Глебовская улица	Киевский район
    Глухой переулок	Холодногорский район
    Гнедича переулок	Киевский район
    Гоголя улица	Киевский район
    Гольдберговская улица	Основянский район
    Гомоненко улица	Слободской район
    Гомоненко улица	Слободской район
    Гончаренка улица	Слободской район
    Горбанівський переулок	Слободской район
    Гордиенковская улица	Основянский район
    Гордона улица	Слободской район
    Горловская улица	Индустриальный район
    Горловская улица	Индустриальный район
    Горная улица	Холодногорский район
    Горный переулок	Холодногорский район
    Горсоветовская улица	Киевский район
    Горького улица	Новобаварский район
    Горянська улица	Киевский район
    Гостиная улица	Новобаварский район
    Грабовского переулок	Шевченковский район
    Гражданская улица	Киевский район
    Граківська улица	Индустриальный район
    Грековская улица	Основянский район
    Грибоедова улица	Новобаварский район
    Григория Рудика улица	Киевский район
    Григоровская улица	Новобаварский район
    Григоровское шоссе (бывш. Комсомольское шоссе)	Новобаварский район
    Грицевца бульвар	Индустриальный район
    Грицевца улица	Индустриальный район
    Грицевца улица	Индустриальный район
    Грищенко улица	Немышлянский район
    Грищенко улица	Немышлянский район
    Грозненская улица	Основянский район
    Грушевского улица	Новобаварский район
    Губенка улица	Индустриальный район
    Губенко улица	Индустриальный район
    Гуданова улица	Киевский район
    Гудзенко улица (бывш. переулок Расторгуевский)	Новобаварский район
    Гуківський в’їзд 	Новобаварский район
    Дагестанський переулок	Холодногорский район
    Данилевского улица	Шевченковский район
    Даниловский спуск	Киевский район
    Дарвина улица	Киевский район
    Даргомыжского улица	Новобаварский район
    Дарьяльская улица	Индустриальный район
    Дар’яльська улица	Индустриальный район
    Дачная улица	Новобаварский район
    Двадцять Третього Серпня улица	Шевченковский район
    Дванадцятого Квітня улица	Индустриальный район
    Двуречная улица	Киевский район
    Девичья улица (бывш. улица Демченко)	Киевский район
    Дегтярёва переулок	Слободской район
    Дербентская улица	Шевченковский район
    Деревянко улица	Шевченковский район
    Деревянко улица	Шевченковский район
    Дерев’янка улица	Шевченковский район
    Державинская улица	Слободской район
    Джанкойская улица	Шевченковский район
    Джерело переулок	Новобаварский район
    Джерело переулок	Новобаварский район
    Джерельная улица	Московский район
    Дзюбы проспект	Новобаварский район
    Дидро улица	Московский район
    Дизайнерский переулок (бывш. переулок Артёма)	Киевский район
    Дизельная улица	Слободской район
    Диканевская улица	Основянский район
    Динамический переулок	Холодногорский район
    Динамовская улица	Шевченковский район
    Динамовский переулок	Холодногорский район
    Динамівський переулок	Холодногорский район
    Динамічний переулок	Холодногорский район
    Дмитриевская улица	Холодногорский район
    Дмитрия Вишневецкого переулок (бывш. переулок Днепропетровский)	Холодногорский район
    Дмитрия Вишневецкого улица (бывш. улица Днепропетровская)	Холодногорский район
    Днестровская улица	Индустриальный район
    Добродецкого улица	Холодногорский район
    Доватора улица	Новобаварский район
    Долинский переулок	Московский район
    Донбассовский переулок	Холодногорский район
    Донбасівський переулок	Холодногорский район
    Донецкий переулок	Основянский район
    Донець-Захаржевського улица	Киевский район
    Донской переулок	Московский район
    Донца-Захаржевского улица (бывш. улица Донец-Захаржевского)	Киевский район
    Досвідний переулок	Шевченковский район
    Достатку переулок	Немышлянский район
    Достатку улица	Немышлянский район
    Достоевского улица	Основянский район
    Достоєвського в’їзд 	Основянский район
    Драгоманова улица	Немышлянский район
    Драгомировская 	Основянский район
    Драгомировская улица	Основянский район
    Дринова улица	Холодногорский район
    Дробицкая улица	Индустриальный район
    Дружбы Народов улица	Московский район
    Дружбы Народов улица	Киевский район
    Дружна улица	Киевский район
    Дубова аллея	Шевченковский район
    Дудинской улица (бывш. улица Нариманова)	Новобаварский район
    Дудинської улица	Новобаварский район
    Душкина улица	Индустриальный район
    Душкина улица (бывш. улица Тухачевского)	Индустриальный район
    Дігтярний в’їзд 	Киевский район
    Евгения Котляра улица (бывш. Красноармейская улица)	Холодногорский район
    Евгения Плужника улица	Основянский район
    Евгеньевская улица	Московский район
    Евпаторийский проезд	Киевский район
    Екатерининская улица (бывш. улица Примакова)	Новобаварский район
    Електромеханічний переулок	Московский район
    Електроінструментальний переулок	Киевский район
    Еленинская улица	Новобаварский район
    Енакиевская улица	Немышлянский район
    Енисейская улица	Индустриальный район
    Есенина улица	Шевченковский район
    Есенина улица	Шевченковский район
    Жасминовый бульвар	Слободской район
    Жасміновий бульвар	Слободской район
    Железнодорожная улица	Холодногорский район
    Животноводов улица	Немышлянский район
    Жилярди улица	Киевский район
    Жилівський переулок	Холодногорский район
    Житная улица	Холодногорский район
    Житомирская улица	Холодногорский район
    Жмеринская улица	Немышлянский район
    Жуковского проспект	Киевский район
    Жуковского улица	Новобаварский район
    Журавлівська набережная	Киевский район
    Журавлівський спуск	Киевский район
    Жён Мироносиц улица (бывш. улица Совнаркомовская)	Киевский район
    Забайкальский переулок	Слободской район
    Забайкальський переулок	Слободской район
    Заводская улица	Основянский район
    Загородная улица	Московский район
    Загородний въезд	Московский район
    Загородняя улица	Московский район
    Залесская улица	Шевченковский район
    Залютинская улица	Холодногорский район
    Залютинская улица	Холодногорский район
    Заозерна улица	Слободской район
    Западная улица	Основянский район
    Зарянская улица	Холодногорский район
    Захисників України майдан 	Основянский район
    Захисників України улица	Слободской район
    Зачепиловская улица	Шевченковский район
    Защитников Украины площадь	Слободской район
    Звёздная улица	Киевский район
    Здоровья набережная	Московский район
    Здоровья переулок	Московский район
    Зелёная улица	Основянский район
    Земовская улица	Холодногорский район
    Зенітна улица	Шевченковский район
    Зерновая улица	Слободской район
    Зерновая улица	Слободской район
    Зерновой переулок	Слободской район
    Зміївська улица	Основянский район
    Золотий переулок	Слободской район
    Золотой переулок	Слободской район
    Золочевская улица	Холодногорский район
    Зорянская улица	Индустриальный район
    Зубарева улица	Индустриальный район
    Ивана Багмута улица (бывш. улица Потапенко)	Киевский район
    Ивана Камышева улица	Московский район
    Ивана Каркача бульвар	Индустриальный район
    Ивана Каркача переулок	Индустриальный район
    Ивана Каркача переулок	Индустриальный район
    Ивана Поддубного улица	Киевский район
    Иванова улица	Киевский район
    Ивановская улица	Шевченковский район
    Ивановский переулок	Шевченковский район
    Игоря Муратова 	Холодногорский район
    Игоря Муратова улица	Холодногорский район
    Ижевская улица	Холодногорский район
    Ижевский переулок	Новобаварский район
    Измайловская улица	Холодногорский район
    Изобилия переулок	Немышлянский район
    Ильинская улица	Холодногорский район
    Ильича проспект	Новобаварский район
    Индустриальная улица	Индустриальный район
    Индустриальный проспект	Индустриальный район
    Индустриальный проспект (бывш. проспект Фрунзе)	Индустриальный район
    Инженерный переулок	Шевченковский район
    Инициативная улица	Холодногорский район
    Интернатская улица	Киевский район
    Интернациональная улица	Основянский район
    Исаевская улица	Киевский район
    Искринская улица	Московский район
    Искринский переулок	Московский район
    Искусств улица	Киевский район
    Искусств улица (бывш. Краснознаменная улица)	Киевский район
    Исполкомовская улица	Новобаварский район
    Истоминская улица	Московский район
    Истоминский переулок	Московский район
    Кавалеридзе улица	Новобаварский район
    Казахстанская улица	Шевченковский район
    Каменец-Подольская улица	Холодногорский район
    Камская улица	Новобаварский район
    Кам’янець-Подільська улица	Холодногорский район
    Канатный переулок	Новобаварский район
    Кандаурова улица	Холодногорский район
    Кандаурова улица	Холодногорский район
    Кантемира переулок	Киевский район
    Каплуновский переулок (бывш. Краснознаменный переулок)	Киевский район
    Каразина улица	Киевский район
    Карачевское шоссе	Новобаварский район
    Карачівське шоссе	Новобаварский район
    Карбышева переулок	Основянский район
    Каринской улица	Киевский район
    Карпатская улица	Немышлянский район
    Карповская улица	Новобаварский район
    Карташевская улица	Новобаварский район
    Карташівська улица	Новобаварский район
    Карьерная улица	Основянский район
    Карякінська улица	Киевский район
    Катаева улица	Новобаварский район
    Катаєва в’їзд 	Новобаварский район
    Кацарская улица	Холодногорский район
    Качанівська улица	Основянский район
    Каширская улица	Новобаварский район
    Каштановая улица	Слободской район
    Кашубы улица	Холодногорский район
    Квитки-Основьяненко улица	Шевченковский район
    Квиткинская улица	Основянский район
    Квітки-Основ’яненка улица	Шевченковский район
    Квітуча улица	Киевский район
    Кемеровская улица	Немышлянский район
    Керченский переулок	Новобаварский район
    Кибальчича улица	Новобаварский район
    Киевская улица	Основянский район
    Кипренский переулок	Холодногорский район
    Киргизская улица	Немышлянский район
    Кирова улица	Основянский район
    Кирпичова улица	Киевский район
    Кирпичёва улица	Киевский район
    Кисловодская улица	Киевский район
    Китаенко улица	Новобаварский район
    Клавдии Шульженко улица	Новобаварский район
    Классический переулок	Шевченковский район
    Клеменовская улица	Слободской район
    Клинская улица	Шевченковский район
    Клинська улица	Шевченковский район
    Клочковская улица	Шевченковский район
    Клочковский переулок	Холодногорский район
    Клочковский спуск	Шевченковский район
    Клочковский спуск	Шевченковский район
    Клочковська улица	Шевченковский район
    Кнышевский переулок	Новобаварский район
    Кнышевский переулок	Новобаварский район
    Ковпака улица	Киевский район
    Ковтуна улица	Слободской район
    Козакевича улица	Киевский район
    Козакевича улица	Киевский район
    Коксовый переулок	Новобаварский район
    Кокчетавская улица	Холодногорский район
    Колодезная улица	Новобаварский район
    Коломенская улица	Шевченковский район
    Колонная улица	Новобаварский район
    Колосиста улица	Киевский район
    Колосистая улица	Киевский район
    Кольський переулок	Московский район
    Кольцевая улица	Киевский район
    Кольцевой проезд	Индустриальный район
    Командарма Корка улица	Киевский район
    Комбайновская улица	Новобаварский район
    Комитетская улица	Шевченковский район
    Коммунальный проезд	Немышлянский район
    Конарева улица	Основянский район
    Кондукторская улица	Основянский район
    Конева улица	Новобаварский район
    Конный переулок	Основянский район
    Коновченко улица (бывш. улица Гагарина)	Слободской район
    Конопляна улица	Новобаварский район
    Конопляная улица	Новобаварский район
    Конотопская улица	Новобаварский район
    Конотопская улица	Новобаварский район
    Константина Калинина улица (бывш. улица Калинина)	Новобаварский район
    Конституции площадь	Шевченковский район
    Конторская улица (бывш. Краснооктябрьская улица)	Новобаварский район
    Конюшенний переулок	Московский район
    Конюшенный переулок	Московский район
    Конюшиновий переулок	Новобаварский район
    Кооперативная улица	Основянский район
    Копыловская улица	Холодногорский район
    Короленко переулок	Основянский район
    Короленко улица	Киевский район
    Коростельская улица	Новобаварский район
    Корсиковский переулок	Московский район
    Корсиковский проезд	Немышлянский район
    Корчагинцев улица	Немышлянский район
    Косарєва улица	Индустриальный район
    Косиора проспект	Немышлянский район
    Космическая улица	Шевченковский район
    Космическая, 21 бизнес центр Space Hall офис 702 	Шевченковский район
    Космонавтов улица	Шевченковский район
    Костомаровская улица	Киевский район
    Костромская улица	Холодногорский район
    Костычева улица	Слободской район
    Костюринский переулок	Основянский район
    Костёльная улица	Киевский район
    Котельниковская улица	Шевченковский район
    Котляревского улица	Новобаварский район
    Коцарская улица	Холодногорский район
    Коцарская улица	Холодногорский район
    Коцюбинского улица	Шевченковский район
    Коширская улица	Новобаварский район
    Кошкіна улица	Слободской район
    Кравцова переулок	Шевченковский район
    Краматорская улица	Основянский район
    Красная аллея	Новобаварский район
    Красная Поляна улица	Немышлянский район
    Красноармейская улица	Холодногорский район
    Краснодарская улица	Немышлянский район
    Красномаякская улица	Холодногорский район
    Краснопольская улица	Немышлянский район
    Красноуральская улица	Немышлянский район
    Красноярский переулок	Индустриальный район
    красные ряди 	Холодногорский район
    Красные Ряды улица	Холодногорский район
    Красіна улица	Киевский район
    Кременчугская улица	Индустриальный район
    Кривоконевская улица	Холодногорский район
    Криворожская улица	Новобаварский район
    Криничный переулок	Шевченковский район
    Кричевского улица	Киевский район
    Кромская улица	Киевский район
    Кронштадтская улица	Немышлянский район
    Крушельницкого улица	Индустриальный район
    Крылова улица	Новобаварский район
    Крымская улица	Шевченковский район
    Кубанская улица	Индустриальный район
    Кузинский мост	Холодногорский район
    Кузнецкая улица	Шевченковский район
    Кузнецкий въезд	Шевченковский район
    Кузнечная улица	Основянский район
    Кузнечний в’їзд 	Основянский район
    Кузнечный переулок	Основянский район
    Куликовская улица (бывш. улица Мельникова)	Киевский район
    Куликовский спуск (бывш. улица Революции)	Киевский район
    Кулиничёвская улица	Немышлянский район
    Культкомовская улица	Новобаварский район
    Культуры улица	Шевченковский район
    Купянская улица	Московский район
    Кураховская улица	Новобаварский район
    Куриловская улица	Холодногорский район
    Курилівський в’їзд 	Холодногорский район
    Куряжанский переулок	Холодногорский район
    Кутаисская улица (бывш. Октябрьская улица)	Основянский район
    Кутова улица	Шевченковский район
    Кутова улица	Шевченковский район
    Кутузовская улица	Шевченковский район
    Лагерная улица	Холодногорский район
    Ладожский переулок	Московский район
    Лазковский мост	Киевский район
    Лазневий переулок	Основянский район
    Лазневий переулок	Основянский район
    Лазьковка-Лужок улица	Киевский район
    Лазьковский переулок	Киевский район
    Лазьківка улица	Киевский район
    Лазьківський проезд	Киевский район
    Латвийская улица	Немышлянский район
    Латышева улица	Киевский район
    Лебединская улица	Слободской район
    Левченко улица	Холодногорский район
    Лейпунского улица	Киевский район
    Лелюковская улица	Основянский район
    Ленина проспект	Шевченковский район
    Ленина проспект	Шевченковский район
    Ленина улица	Шевченковский район
    Лермонтовская улица	Киевский район
    Леси Украинки улица	Московский район
    Лесопарковская улица	Киевский район
    Лесопарковская улица	Киевский район
    Леся Сердюка улица	Киевский район
    Лизы Чайкиной переулок	Новобаварский район
    Лиманский переулок	Основянский район
    Литвиновская улица	Киевский район
    Литвиновская улица	Киевский район
    Литературная улица (бывш. улица Ярослава Галана)	Шевченковский район
    Лодзинская улица	Немышлянский район
    Лозовеньківський проспект	Шевченковский район
    Лозовская улица	Холодногорский район
    Лозовська улица	Холодногорский район
    Локомотивная улица	Основянский район
    Ломоносова улица	Новобаварский район
    Лопанская набережная	Холодногорский район
    Лопанская улица	Шевченковский район
    Лопанский переулок	Холодногорский район
    Лопанська улица	Шевченковский район
    Лопатинский переулок	Основянский район
    Лопатинський переулок	Основянский район
    Лосевская улица	Немышлянский район
    Лосевский переулок	Холодногорский район
    Лосівська улица	Индустриальный район
    Лосівський переулок	Холодногорский район
    Луганская улица	Киевский район
    Луговская улица	Немышлянский район
    Луи Пастера улица	Индустриальный район
    Лукьяновская улица	Холодногорский район
    Лук’янівська улица	Холодногорский район
    Лысенко улица	Новобаварский район
    Льва Ландау 241 А проспект	Московский район
    Льва Ландау проспект (бывш. улица 50 лет СССР)	Немышлянский район
    Льва Толстого улица	Киевский район
    Льговская улица	Основянский район
    Льговська улица	Основянский район
    Любови Малой проспект	Новобаварский район
    Люботинский переулок	Московский район
    Людвига Свободи проспект	Шевченковский район
    Людвига Свободы проспект	Шевченковский район
    Людмилы Гурченко переулок (бывш. Саммеровский переулок)	Шевченковский район
    Люсинская улица	Киевский район
    Лютовская улица	Новобаварский район
    Лялі Убийвовк улица	Шевченковский район
    Ляпунова улица	Шевченковский район
    Магаданская улица	Московский район
    Магнитогорская улица	Холодногорский район
    Майкопская улица	Немышлянский район
    Макаренко улица	Шевченковский район
    Макеевская улица	Основянский район
    Маковського улица	Новобаварский район
    Максимилиановская улица (бывш. улица Ольминского)	Киевский район
    Малиновская улица	Московский район
    Малиновского улица	Холодногорский район
    Мало-Гончаровская улица	Новобаварский район
    Мало-Гончаровская улица	Новобаварский район
    Мало-Панасовская улица	Холодногорский район
    Мало-Панасовский переулок	Холодногорский район
    Малогончарівська улица	Новобаварский район
    Малоджанкойская улица	Шевченковский район
    Маломосковская улица	Московский район
    Маломясницкая улица	Основянский район
    Малом’ясницька улица	Основянский район
    Малопанасівська улица	Холодногорский район
    Манизера улица	Киевский район
    Манизера улица (бывш. улица Красина)	Киевский район
    Манченківська улица	Киевский район
    Марка Бернеса улица	Новобаварский район
    Маршала Бажанова улица	Киевский район
    Маршала Батицкого улица	Московский район
    Маршала Жукова проспект	Немышлянский район
    Маршала Жукова улица	Шевченковский район
    Маршала Малиновского улица	Холодногорский район
    Маршала Рыбалко улица	Немышлянский район
    Маршала Федоренка улица	Слободской район
    Маршала Федоренко улица	Слободской район
    Марьевская улица	Киевский район
    Марьинская улица	Новобаварский район
    Марьинская улица	Новобаварский район
    Марьяненко переулок	Киевский район
    Мар’яненко переулок	Киевский район
    Мар’їнська улица	Новобаварский район
    Матросова улица	Слободской район
    Матюшенко улица	Киевский район
    Машинистов улица	Основянский район
    Машиностроителей проспект	Холодногорский район
    Машиностроительная улица	Слободской район
    Машиностроительный переулок	Слободской район
    Маяковского улица	Киевский район
    Медицинская улица	Немышлянский район
    Межлаука улица	Немышлянский район
    Менделеева улица	Новобаварский район
    Мерефянское шоссе	Основянский район
    Мерефянське шоссе	Основянский район
    Мереф’янське шоссе	Основянский район
    Металлиста улица	Московский район
    Металлистов улица	Шевченковский район
    Метизный переулок	Новобаварский район
    Метростроителей улица	Киевский район
    Мефодиевская улица	Слободской район
    Мефодіївська улица	Слободской район
    Механизаторов улица	Индустриальный район
    Механический переулок	Московский район
    Микитенко улица	Основянский район
    Минераловодская улица	Киевский район
    Минская улица	Шевченковский район
    Мира 	Шевченковский район
    Мира 	Киевский район
    Мира 	Киевский район
    Мира бульвар	Киевский район
    Мира переулок	Индустриальный район
    Мира улица	Индустриальный район
    Мира улица	Индустриальный район
    Миргородская улица	Основянский район
    Мирная улица	Шевченковский район
    Мироновская улица	Холодногорский район
    Мироносицкая улица	Киевский район
    Мироносицька 15 улица	Киевский район
    Митинговый переулок	Холодногорский район
    Михаила Водяного улица (бывш. улица Щербакова)	Индустриальный район
    Михайла Гуревича улица	Киевский район
    Михайлика улица	Московский район
    Михайлика улица	Московский район
    Мичурина улица	Основянский район
    Мовчанівський переулок	Основянский район
    Могилевская улица	Немышлянский район
    Моисеевская улица	Киевский район
    Мойсеївська улица	Киевский район
    Молодой Гвардии улица	Слободской район
    Молодёжная улица	Индустриальный район
    Молокина улица	Основянский район
    Молочная улица (бывш. улица Кирова)	Основянский район
    Молчановский переулок	Основянский район
    Монгольский переулок	Новобаварский район
    Монтажная улица	Шевченковский район
    Монюшко улица	Слободской район
    Морозова улица	Слободской район
    Мороховецкая набережная	Новобаварский район
    Москаленка улица	Киевский район
    Москалёвская улица (бывш. улица Октябрьской Революции)	Новобаварский район
    Московская улица	Новобаварский район
    Московский проспект	Немышлянский район
    Московский проспект	Индустриальный район
    Мотронинская улица	Немышлянский район
    Мохначанская улица	Индустриальный район
    Музыкальная улица	Шевченковский район
    Муромский переулок	Киевский район
    Муромский проезд	Киевский район
    Муромська улица	Киевский район
    Мухачева улица	Слободской район
    Мухачова улица	Слободской район
    Мясной переулок	Основянский район
    Мясной переулок	Основянский район
    М’ясний переулок	Основянский район
    Набережная улица	Холодногорский район
    Набережный переулок	Шевченковский район
    Набережный проезд	Холодногорский район
    Нагорная улица	Шевченковский район
    Надборная улица	Основянский район
    Нариманова улица	Новобаварский район
    Народовластия улица	Киевский район
    Нарынская улица	Киевский район
    Натальи Ужвий улица	Киевский район
    Науки проспект	Шевченковский район
    Национальной Гвардии площадь	Новобаварский район
    Національної Гвардії майдан 	Новобаварский район
    ная проспект	Киевский район
    Невельская улица	Немышлянский район
    Невельська улица	Немышлянский район
    Нежинская улица	Холодногорский район
    Нежинский переулок	Холодногорский район
    Независимости проспект (бывш. проспект Правды)	Шевченковский район
    Немышлянская набережная	Немышлянский район
    Немышлянская улица	Немышлянский район
    Нестерова улица	Слободской район
    Нетеченская набережная	Новобаварский район
    Нетеченская улица	Основянский район
    Нетеченский бульвар	Основянский район
    Нетеченська набережная	Новобаварский район
    Нечуй-Левицкого улица	Основянский район
    Нижегородська улица	Киевский район
    Нижнегиевская улица	Холодногорский район
    Низовая улица	Шевченковский район
    Никитина улица	Основянский район
    Никитинский переулок	Основянский район
    Николая Алексина переулок	Новобаварский район
    Николая Бажана улица (бывш. улица Кривомазова)	Новобаварский район
    Николая Манойла улица	Киевский район
    Николая Михновского улица	Основянский район
    Новаторський в’їзд 	Основянский район
    Новгородская улица	Шевченковский район
    Новгородская улица	Шевченковский район
    Ново-Баварский проспект (бывш. проспект Ильича)	Новобаварский район
    Ново-Баварский улица	Новобаварский район
    Ново-Веринская улица	Московский район
    Ново-Толкачівський переулок	Киевский район
    Новоалександровская улица	Киевский район
    Новоалексеевская улица	Шевченковский район
    Новодесятисаженная улица	Основянский район
    Новожановская улица	Новобаварский район
    Новожановский переулок	Новобаварский район
    Новоисаевский переулок	Киевский район
    Новомирная улица	Шевченковский район
    Новомирский переулок	Новобаварский район
    Новомосковская улица	Новобаварский район
    Новомясницкая улица	Основянский район
    Новом’ясницька улица	Основянский район
    Новопригородная улица	Новобаварский район
    Новопроектна улица	Немышлянский район
    Новопрудная улица	Шевченковский район
    Новороссийский переулок	Слободской район
    Новохарківська улица	Московский район
    Новохарьковская улица	Киевский район
    Новочеркасская улица	Холодногорский район
    Новошишковська улица	Киевский район
    Новый Быт улица	Холодногорский район
    Ньютона улица	Слободской район
    Нікітінський переулок	Основянский район
    Обоянская улица	Основянский район
    Одесская улица	Основянский район
    Одесская улица	Основянский район
    Озерянская улица	Холодногорский район
    Озёрная улица	Основянский район
    Окружная дорога (бывш. Кольцевая дорога)	Киевский район
    Олександра Шпейєра улица	Основянский район
    Олеся Гончара улица	Киевский район
    Олимпийская улица	Немышлянский район
    Ольгинская улица	Киевский район
    Ольминского улица	Киевский район
    Омская улица	Киевский район
    Оренбургская улица	Слободской район
    Освитянская улица	Шевченковский район
    Оскольский переулок (бывш. улица Фабрика-Кухня)	Индустриальный район
    Основянская улица	Основянский район
    Основ’янська улица	Основянский район
    Острогожская улица	Киевский район
    Отакара Яроша переулок	Шевченковский район
    Отакара Яроша переулок	Шевченковский район
    Отакара Яроша улица	Шевченковский район
    Офицерская улица	Немышлянский район
    Очаковская улица	Шевченковский район
    Очаковский переулок	Шевченковский район
    Павловская площадь	Шевченковский район
    Павловская площадь	Шевченковский район
    Павловская улица	Шевченковский район
    Павлівський майдан 	Основянский район
    Панасовский проезд	Холодногорский район
    Пантелеймона Свистуна улица (бывш. Северная улица)	Индустриальный район
    Парашютистов улица	Московский район
    парк культуры і отдыха имени Горького	Шевченковский район
    Партизанская улица	Киевский район
    Пащенковская улица	Холодногорский район
    Первомайский переулок	Холодногорский район
    Переможна улица	Шевченковский район
    Переяславская улица	Холодногорский район
    Пермская улица	Новобаварский район
    Пермский переулок	Новобаварский район
    Пестеля улица	Киевский район
    Пестрикова улица	Новобаварский район
    Песчаная набережная	Шевченковский район
    Песчаная улица	Шевченковский район
    Петра Болбочана улица	Холодногорский район
    Петра Григоренко проспект (бывш. проспект Маршала Жукова)	Слободской район
    Петра Григоренко улица	Шевченковский район
    Петра Набойченко улица	Новобаварский район
    Петра Свинаренко улица	Новобаварский район
    Петра Тронько улица	Холодногорский район
    Петра Широнина улица	Шевченковский район
    Петра Ширяева улица	Основянский район
    Петровского улица	Киевский район
    Петрозаводская улица	Немышлянский район
    Пехотный переулок	Шевченковский район
    Пешкова улица	Киевский район
    Пилотов переулок	Слободской район
    Пильчикова улица	Слободской район
    Пирогова улица	Индустриальный район
    Писемского переулок	Московский район
    Писемського переулок	Московский район
    Пискуновская улица	Холодногорский район
    Пискуновский переулок	Холодногорский район
    Пискунівський переулок	Холодногорский район
    Планерная улица	Основянский район
    Плановая улица	Новобаварский район
    Пластичный переулок	Холодногорский район
    Плетневский переулок	Основянский район
    Плетневский переулок	Киевский район
    Плехановская 	Слободской район
    плехановская 12 улица	Основянский район
    Плехановская улица	Слободской район
    Плехановский переулок	Слободской район
    Плиточная улица	Индустриальный район
    Плиточний переулок	Индустриальный район
    Плодородная улица	Немышлянский район
    Победителей улица	Новобаварский район
    Победоносная улица	Шевченковский район
    Победы переулок	Немышлянский район
    Победы проспект	Шевченковский район
    Победы проспект	Шевченковский район
    Пограничная улица	Холодногорский район
    Подлесная улица	Холодногорский район
    Подольский переулок	Основянский район
    Подрывной переулок	Московский район
    Поезії майдан 	Киевский район
    пожарный проезд	Шевченковский район
    Пожарского улица	Немышлянский район
    Пожарского улица	Немышлянский район
    Поздовжня улица	Киевский район
    Познанская улица	Московский район
    Полевая улица	Слободской район
    Полиграфическая улица	Индустриальный район
    Полины Осипенко улица	Немышлянский район
    Политехническая улица	Киевский район
    Полтавская улица	Основянский район
    Полтавский путь улица	Новобаварский район
    Полтавский Шлях улица	Холодногорский район
    Полтавський переулок	Новобаварский район
    Полярная улица	Шевченковский район
    Померки улица	Киевский район
    Пономаревский переулок	Киевский район
    Пономарівська улица	Киевский район
    Поречковая улица	Киевский район
    Потебни улица	Киевский район
    Почтовый переулок	Московский район
    Почтовый переулок	Московский район
    Поэзии площадь	Киевский район
    Привокзальная площадь	Холодногорский район
    Привокзальная улица	Основянский район
    Привокзальний майдан 	Холодногорский район
    Привокзальный переулок	Основянский район
    Прикзальна улица	Основянский район
    Примакова улица	Новобаварский район
    Примеровская улица	Московский район
    Приходьковская улица	Киевский район
    Прогрес улица	Холодногорский район
    Прогресс улица	Холодногорский район
    Продольная улица	Киевский район
    Продукти 	Новобаварский район
    Проектная улица	Киевский район
    Профессорская улица	Шевченковский район
    Профсоюзный бульвар	Новобаварский район
    Псковская улица	Холодногорский район
    Пулавська улица	Индустриальный район
    Пулковский переулок	Немышлянский район
    Пушкарівська улица	Новобаварский район
    Пушкина улица	Киевский район
    Пушкинская улица	Киевский район
    Пушкинский въезд	Киевский район
    Пятигорский переулок	Немышлянский район
    Пятисотницкая улица	Новобаварский район
    Пятихатская улица	Индустриальный район
    П’ятихатська улица	Индустриальный район
    Рабкоровская улица	Новобаварский район
    Радиотехническая улица	Новобаварский район
    Раднянская улица	Новобаварский район
    Радіотехнічна улица	Новобаварский район
    Раевской улица	Киевский район
    Раевской улица (бывш. улица Елены Стасовой)	Киевский район
    Разъездной переулок	Основянский район
    Райсоветовский переулок	Новобаварский район
    Революции 1905 года улица	Холодногорский район
    Редина улица	Основянский район
    Резниковский переулок	Холодногорский район
    Речной переулок	Шевченковский район
    Решетниковский переулок	Слободской район
    Решетькинская улица	Киевский район
    Ржевский переулок	Новобаварский район
    Ржепішевського улица	Слободской район
    Рибасівський переулок	Основянский район
    Рижовская улица	Московский район
    Рижовский переулок	Московский район
    Рижівська улица	Шевченковский район
    Рижівський переулок	Московский район
    Риздвяная улица	Холодногорский район
    Риківська улица	Холодногорский район
    Робеспьера улица	Холодногорский район
    Робесп’єра улица	Холодногорский район
    Роганская улица	Индустриальный район
    Роганский переулок	Индустриальный район
    Рогатинский переулок	Шевченковский район
    Рогатинский проезд	Шевченковский район
    Рождественская улица (бывш. улица Энгельса)	Холодногорский район
    Розторгуївський переулок	Новобаварский район
    Ромашкина улица	Слободской район
    Ромен Роллана улица	Шевченковский район
    Ромена Роллана улица	Шевченковский район
    Ростовская улица	Киевский район
    Рубановская улица	Новобаварский район
    Рубановский переулок	Новобаварский район
    Рудика улица	Киевский район
    Рудинская улица	Московский район
    Руднева площадь	Основянский район
    Рудничная улица	Основянский район
    Румянцевская улица	Индустриальный район
    Румянцевская улица (бывш. улица Орджоникидзе)	Индустриальный район
    Руслана Плоходько улица	Московский район
    Руставели улица	Основянский район
    Руставелі переулок	Основянский район
    Руставелі улица	Основянский район
    Рыбалко улица	Немышлянский район
    Рыбасовская улица	Основянский район
    Рыбная площадь	Основянский район
    Рылеева переулок	Новобаварский район
    Рылеева улица	Холодногорский район
    Рымарская улица	Шевченковский район
    Рынок Барабашово 	Киевский район
    Рязанская улица	Шевченковский район
    Різниківський переулок	Холодногорский район
    Сабуровская набережная	Московский район
    Сабуровская набережная (бывш. набережная Крупской)	Московский район
    Сабуровская улица	Московский район
    Сабуровская улица	Московский район
    Савченків переулок	Холодногорский район
    Сагайдачного улица	Киевский район
    сад им. Тараса Шевченко	Шевченковский район
    Садовая улица	Киевский район
    Садовая улица (бывш. улица Чубаря)	Киевский район
    Садово-парковая улица	Слободской район
    Садовопаркова улица	Слободской район
    Садовских переулок	Московский район
    Садовый бульвар	Киевский район
    Садовый проезд	Слободской район
    Садовый проезд	Слободской район
    Салтовская линия метро	Киевский район
    Салтовское шоссе	Московский район
    Салтівське шоссе	Московский район
    Самаркандская улица	Слободской район
    Самокиша переулок	Шевченковский район
    Самолётная улица	Основянский район
    Самсоновская улица	Московский район
    Самсонівська улица	Московский район
    Санжаревский переулок	Московский район
    Сапёрная улица	Киевский район
    Сапёрный переулок	Киевский район
    Саратовская улица	Основянский район
    Саратовский переулок	Основянский район
    Саржинская улица	Шевченковский район
    Саржинська улица	Шевченковский район
    Сахалинская улица	Московский район
    Сватовская улица	Холодногорский район
    Свет Шахтёра переулок	Новобаварский район
    Свет Шахтёра улица	Новобаварский район
    Светлановская улица	Новобаварский район
    Светлая улица	Московский район
    Свободи майдан 	Шевченковский район
    Свободы площадь	Шевченковский район
    Свободы улица	Киевский район
    Свободы улица (бывш. улица Иванова)	Киевский район
    Связи улица	Шевченковский район
    Святодуховская 	Московский район
    Святодуховская улица	Московский район
    Севастопольская улица	Шевченковский район
    Северина Потоцкого улица (бывш. улица XVII Партсъезда)	Индустриальный район
    Северная улица	Немышлянский район
    Северный переулок	Индустриальный район
    Северо-Донецкий переулок	Основянский район
    Северокавказская улица	Новобаварский район
    Селянская улица	Новобаварский район
    Семена Кузнеця улица	Шевченковский район
    Семеновский переулок	Киевский район
    Семиградская улица	Московский район
    Семиградский переулок	Московский район
    Семиградський в’їзд 	Московский район
    Семинарская улица (бывш. улица Володарского)	Новобаварский район
    Семка улица	Основянский район
    Семко улица	Основянский район
    Семёна Кузнеца улица	Шевченковский район
    Семёна Челюскина улица	Киевский район
    Серафимовича улица	Холодногорский район
    Сергея Грицевца улица	Индустриальный район
    Сергея Есенина улица	Шевченковский район
    Сергея Орешкова улица	Основянский район
    Сергея Тархова улица	Индустриальный район
    Сергиевская улица	Московский район
    Сергія Грицевця улица	Индустриальный район
    Сергіївський майдан 	Шевченковский район
    Сериковская улица	Холодногорский район
    Серповая улица	Шевченковский район
    Сивашская улица	Индустриальный район
    Сиверская улица	Немышлянский район
    Сиверская улица	Немышлянский район
    Сидельниковский переулок	Основянский район
    Сидора Ковпака улица	Киевский район
    Сидоренковская улица	Основянский район
    Симферопольский переулок	Новобаварский район
    Симферопольское шоссе	Основянский район
    Скобелевская улица	Киевский район
    Сковородиновская улица	Холодногорский район
    Скрипника улица	Киевский район
    Славы проспект	Холодногорский район
    Славянская улица	Холодногорский район
    Слесарный переулок	Киевский район
    Слобожанская улица	Слободской район
    Словянская улица	Холодногорский район
    Слов’янська улица	Холодногорский район
    Служебная улица	Новобаварский район
    Смольная улица	Слободской район
    Снегирёвский переулок	Немышлянский район
    Соборный спуск	Шевченковский район
    Советский переулок	Киевский район
    Современная улица	Киевский район
    Соича улица	Слободской район
    Сокольники парк 	Шевченковский район
    Сокольники улица	Шевченковский район
    Сокольницкая улица	Шевченковский район
    Сокольническая улица	Шевченковский район
    Сокільники 	Шевченковский район
    Солнечная улица	Немышлянский район
    Солнечногорская улица	Киевский район
    Соляниковский переулок	Основянский район
    Сомовская улица	Московский район
    Сонячний переулок	Киевский район
    Сонячногірська улица	Киевский район
    Софиевская улица	Шевченковский район
    Сохора улица	Основянский район
    Сочинская улица	Холодногорский район
    Спартака улица	Московский район
    Спартаковский переулок	Шевченковский район
    Спиридоновская улица	Слободской район
    Спортивная улица	Московский район
    Спортивный переулок	Московский район
    Среднеуральская улица	Слободской район
    Стадионный проезд	Немышлянский район
    Станковая улица	Индустриальный район
    Станкостроительная улица	Индустриальный район
    Станционный въезд	Новобаварский район
    Станційна улица	Новобаварский район
    Станційний в’їзд 	Новобаварский район
    Старицкого улица	Шевченковский район
    Старобельский переулок	Холодногорский район
    Старобельський переулок	Холодногорский район
    Старова улица	Киевский район
    Староверещаковская улица	Основянский район
    Старомосковский переулок	Слободской район
    Старомосковська улица	Слободской район
    Старопрудная улица	Холодногорский район
    Старошишковская улица	Киевский район
    Стартовая улица	Слободской район
    Степная улица	Новобаварский район
    Степной переулок	Новобаварский район
    Столярный переулок	Новобаварский район
    Стрелецкий переулок	Слободской район
    Строительная улица	Киевский район
    Студенческая улица	Киевский район
    Студенческий переулок	Киевский район
    Суздальские Ряды улица	Холодногорский район
    Сумгаитская улица	Шевченковский район
    Сумская улица	Шевченковский район
    Сурикова переулок	Холодногорский район
    Сухумская улица	Шевченковский район
    Сущенская улица	Новобаварский район
    Счастливая улица	Холодногорский район
    Сычевский переулок	Слободской район
    Сімферопольське шоссе	Основянский район
    Таганская улица	Холодногорский район
    Таганский переулок	Холодногорский район
    Таджикская улица	Индустриальный район
    Танковая улица	Немышлянский район
    Танкопия переулок	Немышлянский район
    Танкопия улица	Немышлянский район
    Танєєва переулок	Новобаварский район
    Тарасовская улица	Слободской район
    Тарасовский переулок	Слободской район
    Тарасівський переулок	Слободской район
    Тахиаташская улица	Киевский район
    Ташкентская улица	Холодногорский район
    Театральная площадь	Киевский район
    Театральный переулок	Киевский район
    Текстильная улица	Основянский район
    Тепличная улица	Киевский район
    Тепловозная улица	Слободской район
    Териховская улица	Холодногорский район
    Тернопольская улица	Основянский район
    тиимуровцев 	Московский район
    Тимирязева улица	Новобаварский район
    Тимирязева улица	Новобаварский район
    Тираспольская улица	Новобаварский район
    Тисова улица	Киевский район
    Титаренковский переулок	Новобаварский район
    Тобольская улица	Шевченковский район
    Толбухина улица	Шевченковский район
    Толстого улица	Киевский район
    Тополевая улица	Московский район
    Торговая улица	Новобаварский район
    Тракторная улица	Немышлянский район
    Тракторостроителей 	Московский район
    Тракторостроителей проспект	Московский район
    Транспортная колонна улица	Киевский район
    Третья улица	Новобаварский район
    Тринклера улица	Шевченковский район
    Троицкий переулок (бывш. переулок Ивана Дубового)	Основянский район
    Трофимовский переулок	Холодногорский район
    Трубная улица	Немышлянский район
    Трудовая улица	Киевский район
    Труфанова улица	Киевский район
    Трінклера в’їзд 	Шевченковский район
    Тульчинский переулок	Новобаварский район
    Тургеневская улица	Шевченковский район
    Тургенівська улица	Шевченковский район
    Туркестанская улица	Немышлянский район
    Тюменский переулок	Новобаварский район
    Тюринская улица (бывш. улица Якира)	Киевский район
    Украинская улица	Основянский район
    ул.Ак.Павлова 44, б ТРЦ Фрунцузкий , Kharkiv, Харківська область, 61000 бульвар	Московский район
    Унеченский переулок	Немышлянский район
    Унечский переулок	Немышлянский район
    Унечский переулок	Немышлянский район
    Университетская улица	Шевченковский район
    Университетский переулок	Шевченковский район
    Урожайная улица	Новобаварский район
    Ушакова улица	Московский район
    Фанинский переулок	Шевченковский район
    Фейербаха переулок	Московский район
    Фейербаха площадь	Московский район
    Фейербаха площадь	Московский район
    Фейербаха улица	Московский район
    Феодосийская улица	Шевченковский район
    Ферганская улица	Немышлянский район
    Фермерская улица	Новобаварский район
    Фесенковская улица	Слободской район
    Фесенковский въезд	Слободской район
    Фестивальная улица	Киевский район
    Физкультурная улица	Киевский район
    Фисановича улица	Московский район
    Фонвизина улица	Слободской район
    Франковская улица	Московский район
    Франтишека Крала улица	Индустриальный район
    Фроловский переулок	Шевченковский район
    Фронтовая улица	Шевченковский район
    Фронтовиков бульвар	Шевченковский район
    Фізкультурний переулок	Киевский район
    Хабарова улица	Немышлянский район
    Халтурина переулок	Московский район
    Халтурина улица	Московский район
    Харьковская набережная	Московский район
    Харьковская улица	Основянский район
    Харьковских Дивизий улица	Слободской район
    Харьковских Дивизий улица	Немышлянский район
    Хозяйственная улица	Новобаварский район
    Холодногорская улица (бывш. улица Елизарова)	Холодногорский район
    Холодногорско-Заводская линия метро	Основянский район
    Хотомлянская улица	Индустриальный район
    Храмова улица	Слободской район
    Хрустальный переулок	Холодногорский район
    ХТЗ улица	Индустриальный район
    Цезаря Кюи улица	Шевченковский район
    Целиноградская улица	Шевченковский район
    Цементна улица	Новобаварский район
    Цементная улица	Новобаварский район
    Цигаревский переулок	Основянский район
    Цигарівський переулок	Основянский район
    Цимлянский переулок	Новобаварский район
    Чайковская улица	Киевский район
    Чаплигінський переулок	Новобаварский район
    Чаплыгинский переулок	Новобаварский район
    Чеботарская улица	Холодногорский район
    Чеботарский переулок	Холодногорский район
    Чебышева улица	Киевский район
    Челюскинцев улица	Киевский район
    Червона Алея улица	Новобаварский район
    Червоношкільна набережная	Основянский район
    Чередниченковский переулок	Холодногорский район
    Чередниченківська улица	Холодногорский район
    Черепановых улица	Новобаварский район
    Черкасская улица	Холодногорский район
    Чернивецкая улица	Киевский район
    Черниговский проезд	Холодногорский район
    Черновицкая улица	Киевский район
    Черноморская улица	Слободской район
    Чернышевская улица	Киевский район
    Черёмушная улица	Основянский район
    Чехова улица	Новобаварский район
    Чкалова улица	Киевский район
    Чувашская улица	Новобаварский район
    Чугуевская улица	Основянский район
    Чуйковская улица	Киевский район
    Чукотская улица	Московский район
    Шаляпина улица	Киевский район
    Шаповалiвський 	Новобаварский район
    Шаповаловский переулок	Новобаварский район
    Шаповалівський переулок	Новобаварский район
    Шариковая улица	Индустриальный район
    Шариковый проезд	Индустриальный район
    Шатилова Дача улица	Шевченковский район
    Шатиловская улица (бывш. улица Ленина)	Шевченковский район
    Шацкая улица	Киевский район
    Шевченко улица	Киевский район
    Шевченковский переулок	Киевский район
    Шевченківський переулок	Киевский район
    Шекспира переулок	Шевченковский район
    Шекспира улица	Шевченковский район
    Шелковичная улица	Шевченковский район
    Шепетовский переулок	Новобаварский район
    Шестопарк переулок	Холодногорский район
    Шиловский переулок	Киевский район
    Широніна улица	Шевченковский район
    Шишковская улица	Киевский район
    Школьная улица	Московский район
    Шляхова улица	Немышлянский район
    Шолом-Алейхема улица	Киевский район
    Шота Руставели переулок	Основянский район
    Шота Руставели улица	Основянский район
    Шумана переулок	Немышлянский район
    Шумана улица	Немышлянский район
    Щепкина улица	Киевский район
    Щигровская улица	Новобаварский район
    Щигрівська улица	Новобаварский район
    Электровозная улица	Индустриальный район
    Электроинструментальный переулок	Киевский район
    Электромеханический переулок	Московский район
    Энвера Ахсарова улица	Шевченковский район
    Энергетическая улица	Слободской район
    Эрлиха улица	Основянский район
    Эстакадная улица	Основянский район
    Юбилейная улица	Немышлянский район
    Юбилейный проспект	Московский район
    Южная улица	Основянский район
    Южнопроектная улица	Основянский район
    Юлия Чигирина улица	Московский район
    Юмтовский переулок	Слободской район
    Юннатов улица	Холодногорский район
    Юности улица	Индустриальный район
    Юри Зойфера улица	Шевченковский район
    Юрия Гагарина проспект	Слободской район
    Юрия Гагарина проспект	Основянский район
    Юрия Кнорозова улица	Киевский район
    Юрия Лавриненко улица	Московский район
    Юрия Паращука улица	Новобаварский район
    Юры Зойфера улица	Шевченковский район
    Юрьевская улица	Московский район
    Юрьевский переулок	Московский район
    Юр’єва бульвар	Немышлянский район
    Юр’ївська улица	Московский район
    Яблоневая улица	Немышлянский район
    Яблоневый проезд	Немышлянский район
    Якутская улица	Московский район
    Якутский переулок	Московский район
    Яровая улица	Киевский район
    Ярослава мудрого 30а 	Киевский район
    Ярослава Мудрого улица (бывш. улица Петровского)	Киевский район
    Ярославская улица	Холодногорский район
    Ясеневая улица	Немышлянский район
    Ясеневая улица	Немышлянский район
    Яснополянская улица	Новобаварский район
    Євгена Котляра улица	Холодногорский район
    Єлизаветинська улица	Основянский район
    Івана Зарудного улица	Московский район
    Ігоря Муратова улица	Холодногорский район
    Інтернатська улица	Киевский район
    Істомінська улица	Московский район
